EEEEEEEEEEEEEEEEEEEEEEEEEEEEEEEEEEEEEEEEEEEEEEE
EEEEEEEEEEEEEEEEEEEEEEEEEEEEEEEPPPPPPPPPPPPPLEE
EEMMMPPPMMMMPLEEEEEEEEEEEEEEEEEEEHHHHHHHEEEELEE
EEEEEEEEEEEEELPPPPPPPPLPPPPPPPPPLEEEEEEEPPPPPPP
EEEEEEEEEEEEELEEEEEEEELEEEEEEEEELEEEEEEEEEEEEEE
MMMMMMMMMMMMMMMMMMMMMMMMMMMMMMMMMMMMMMMMMMMMMMM
