EEEEEEEEEEEEEEEEEEEEEEEEEEEEEEEEEEEEEEEEEEEEEEE
EEEEEEEEEEEEEEEEEEEEEEEEEEEEEEEPPPPPPPPPPPPPLEE
EEMMMPPPMMMMPLEEEEEEEEEEEEEEEEEEEEEEEEEEEEEELEE
EEEEEEEEEEEEELPPPPPPPPLPPPPPPPPPLHHHHHHHPPPPPPP
EEEEEEEEEEEEELEEEEEEEELEEEEEEEEELEEEEEEEEEEEEEE
MMMMMMMMMMMMMMMMMMMMMMMMMMMMMMMMMMMMMMMMMMMMMMM
