EEEEEEEEEEEEEEEEEEEEEEEEEEEEEEEEEEEEEEEEEEEEEEE
EEEEEEEEEEEEEEEEEEEEEEEEEEEEEEEPPPPPPPPPPPPPLEE
EEMMMPPPMMMMPLEEEEEEEEEEEEEEEEEEEHHHHHHHEEEEEEE
EEEEEEEEEEEEELPPPPPPPPLPPPPPPPPPLEEEEEEEPPPPPPP
EEEEEEEEEEEEELEEEEEEEELEEEEEEEEELEEEEEEEEEEEEEE
MMMMMMMMMMMMMMMMMMMMMMMMMMMMMMMMMMMMMMMMMMMMMMM
