EEEEEEEEEE
EEEEEEEEEE
EEEEEEEEEE
EEEPPLPPPP
EEEEELEEEE
EEEEELEEEE
EEEEELEEEE
PPPPPPPPPP
MMMMMMMMMM