EEEEEEEEEE
EEEEEEEEEE
EEEEEEHHHE
EEPLPPEEEP
EEELEEEEEE
EEELEEEEEE
EEELEEEEEE
PPPPPPPPPP
MMMMMMMMMM